**********
**********
**********
***B******
***#******
*##E****S*
**********
**********
**********
**********