**********
**********
**********
***B******
***#******
*##ES*****
**********
**********
**********
**********