....##....
..........
..........
..........
#........#
#........#
..........
..........
..........
....##....