----------
----------
##########
#........#
D........D
D........D
#........#
##########
----------
----------